0000000000000000
0000000000000003
0000000000000101
0000000011100000
0001100000000000
0000000000100000
0100000000000000
2010000000000000
0000010000000000
0000000000000000
0010000000000000
1110111110011000