0000000000000000
0000000000000000
0000000000000000
0000000000000000
0000000000000000
0000000000000000
0200000000000000
0111000000400000
0000000011110000
0000000000000000
0300000040000000
0111111111000000