0000000000000000
0000000000000000
0000000000000000
1000000000000000
1000000000000000
1200000000000000
1111000000000000
1000000044400000
1011111111000000
0000000000000001
0300000040001110
1111111111100000