0000000000000000
0000000000000000
0000000000000000
0000000000000000
0000000000000000
0000000000000000
0000000000000000
0000000000030000
0000000001110000
0000111000000000
0200000000000000
1111111111111111